■■■■■■■■■■■■■■■■■■■■■■■■■■■■
█                          █
█  ■■■■  ■  ■■■■  ■  ■■■■  █
█  ■  ■  ■        ■  ■  ■  █
█  ■■■■  ■  ■  ■  ■  ■■■■  █
█        ■  ■  ■  ■        █
█  ■■■■■■■  ■  ■  ■■■■■■■  █
█  ■                    ■  █
█  ■  ■■■■■■■  ■■■■■■■  ■  █
█                          █
█  ■■■■■■■  ■■■■  ■■■■■■■  █
█           ■  ■           █
█  ■■■■  ■  ■■■■  ■  ■■■■  █
█  ■  ■  ■        ■  ■  ■  █
█  ■■■■  ■  ■■■■  ■  ■■■■  █
█        ■  ■  ■  ■        █
█  ■■■■■■■  ■■■■  ■■■■■■■  █
█                          █
■■■■■■■■■■■■■■■■■■■■■■■■■■■■